-------------------------------------------------------------------------------------------------------------------------------M------------------------------------------------------------------------
---B---------------------------------------------------------------------M------------------------------------------------------------------------------------------------------------------------------
------------------------------------------------------------------------------------------------------B------------X------------------------------------------------------------------------------------
-----------------------------------------------------------------------------------B--------------------------------------------------------?-----------------------------------------------------------
----------------------------------------------------------BBX-------------------------------------------?------------------------------------o------------------------------------------BBBBBB----------
-------------------------------------------------------?-M------------------------------------------X-------------B--------------------------------------------M----------------------------------------
---------------------------------------------------------------------------------------------------XX-------------------T-----------------------------------------o-------------------------------------
---------------------------------------------------------------------------------------------?????XXX-------------------|-----------------MT--------------------o--------------------------------------v
---------------------------------------------------------------------T---------------------------XXXX------------------X|------------------|--------------------------------------XXXX-----------------f
---------------------------------------------------------------------|---------------------XXXXXXXXXX---------------X---|------------------|-----------------------------------------------------------f
--------------------------------------------X--BBBBB-T--T-o----------|-------T--------T--------XXXXXX-----------B-------|--------T---BBBBB-|------------------------------------B-------------------?--f
----------------------T------------------------------|--|---?--T-----|-------|--------|-------XXXXXXX-------------------|--------|---------|T-------------------------------------T--------------------f
----------------------|------------------------------|--|------|-----|-------|--------|------XXXXXXXX-------------------|--------|-----X---||-------------------------------------|--------------------f
--T-------------------|-------------------------XXXXX|--|------|-----|-------|--XXXXXX|-----XXXXXXXXX-------------------|-----X--|---------||-------------------------------------|---------T----------f
m-|-------------------|-----------------X-E----------|E-|------|-----|-------|--------|----XXXXXXXXXX--------------E----|-EE-XX-E|----o-E--||-----B-E-----------------------------|---------|----------X
XX|XXXXXXXXXXXXXXXXXXX|XXXXXXXXXXX-XX---XX--XXXBXXX--|-X|XXXXXX|XXXXo|XXXXXXX|XXXXXXXX|X--XXXXXXXXXXXX-------XXXXXXXXXXX|XX-XXX--|XX--XXXXX||XXXXXXXXXXXXXXXXXXX----XXXXXXXXXXXXXX|XXXXXXXXX|XXo------XX
