o-oo--B--E--o-M-----?--------E---B--?------o-M------B------o-----------?Eo---o--EE---M-BE-B----------Bo---E------------oE-----MEo--B-----------------------?----BM----o-E-------M-?---?------E---oE?---?
Bo?E----Eo-?BE-------E-----o-E-----EE-M---B-----o-----o--------o----M---------E----------E-------------B--Bo-Bo-----E---M--M----------oo-E-E------M---M----o-E-o--M---?B----------o-M----EE----B---o---B
o--------E-----------E---E---------------------B------o---M--E-o---E--ME----------------M----E---------E------E--E---------o---o-----E---E-----E?o------?E--Eo---M--------M---M-E----?Eo-o-------o---E-|
ME------------oB------B-----o-----M---o------E------EB----E-o-------EBE-----o---o---M-----?-------E----o--------ME-------oo--E?---------?---E----B----o----E--E---E-----M-o-B--B-------?E?---oE----o---B
M----B----------oo?--E-------------o-------o--?---------M------o---------------------BB----------o-Bo--B------B---E--?-------M---------?------o------E---o-----?-----------oE------o----E--------------M
|------o-----?-MBME------o---M----?---o---B?----o----------?------M---E----oo-----E------B----E-----M-------B-----------------o--B---?--o-------M-B-M-------------B------o-----o-------EB--B---?-------o
o-----M-E?------o---?----------B-?-------oE-------o?-o----M--E--M--M----------EoM-M---------o-----E----E----------?----M--------B-oM------M--E--------M-?--------oE--E--?---EB--o--------o---------M---M
B--------E--------M----M----o------------------oM---------E------?-oo-o?-?---oBM--E----E--E--oE?----ooo--------M--o----E----------?----------B----Mo------------E-----oE-oE----------------?--o---oo---v
XEo---o----E----?----------o---E------?------BE----B-B----?--------M-o--?-------o---?------oM--------o------------o----------oBE-Mo-------------?---?E---B-MM?--------?--M-o-?-----BE-M------B-o--E-E---
M-------M----E-----M--o---oo-----oo----?-B---E-B-E--?E--E--BE---E--------E--o--M-E----o--M--------o---M--E------oo--------E----M--------E--MEM---------E----o--------E--------B--------o-B------o------?
M-----E-o------B-o----E---E--------EE----E-------M---B-B----o------E--------M-o---------MEoE--E----M-oo-------M---EB?-------------------B--E--?B-B-B---?ooo----ooo-----?E--------?-------------o-----o-|
---E----B--E-B---------M----B--------M--Eo??-----E------------M----------o-?----E--?------E-------?-------------------E----B-----B------o----------E-BM--o--E-o?-B-M---oo-?E-?----------E--------M-o---?
B----------o--?----oB----MT-------oX---?--T|----?--Bo------X----?|----B-E-M-|----T---M--T-?--o--B-----|-BB-M---------X-------T---|----------??|?-------oMB-B----T----o?-B--?----oT|--XX-?-----o--|?B---?
-------------T-------M-|-MX--o|--|-|---M---X---?---o-B---B---T----M---X-X-|--?M---?------X-o----|-----XT-------BB-X-----?X--X---o|----B--M-o|--|--M---|---|----M-?X----?----Xo---X---E-M---M-M-E-|-----X
m----------?-|--BT-----T---E--oE---X----o-M---oT-o-|--M----------X--|-M?-T-------B-?|-X----oE----X-o|-E------Bo------M--?----B----|o-M-?----|-XX-|-XBEXToXE-|-?-Mo--------?|---B--M------o-T---?-?BB-?-E
XXXXXXXXXXXXXXXXXXXXXXXXXXXXXXXXXXXXXXXXXXXXXXXXXXXXXXXXXXXXXXXXXXXXXXXXXXXXXXXXXXXXXXXXXXXXXXXXXXXXXXXXXXXXXXXXXXXXXXXXXXXXXXXXXXXXXXXXXXXXXXXXXXXXXXXXXXXXXXXXXXXXXXXXXXXXXXXXXXXXXXXXXXXXXXXXXXXXXXXX
