o-oo--B-----o-M-----?------------B--?------o-M------B------o-----------?-o---o-------M-B--B----------Bo----------------o------M-o--B-----------------------?----BM----o---------M-?---?----------o-?---?
Bo?------o-?B--------------o----------M---B-----o-----o--------o----M----------------------------------B--Bo-Bo---------M--M----------oo----------M---M----o---o--M---?B----------o-M----------B---o---B
o----------------------------------------------B------o---M----o------M-----------------M----------------------------------o---o----------------?o------?----o---M--------M---M------?-o-o-------o-----|
M-------------oB------B-----o-----M---o--------------B------o--------B------o---o---M-----?------------o--------M--------oo---?---------?--------B----o-----------------M-o-B--B-------?-?---o-----o---B
M----B----------oo?----------------o-------o--?---------M------o---------------------BB----------o-Bo--B------B------?-------M---------?------o----------o-----?-----------o-------o-------------------M
|------o-----?-MBM-------o---M----?---o---B?----o----------?------M--------oo------------B----------M-------B-----------------o--B---?--o-------M-B-M-------------B------o-----o--------B--B---?-------o
o-----M--?------o---?----------B-?-------o--------o?-o----M-----M--M-----------oM-M---------o---------------------?----M--------B-oM------M-----------M-?--------o------?----B--o--------o---------M---M
B-----------------M----M----o------------------oM----------------?-oo-o?-?---oBM-------------o-?----ooo--------M--o---------------?----------B----Mo------------------o--o-----------------?--o---oo---v
X-o---o---------?----------o----------?------B-----B-B----?--------M-o--?-------o---?------oM--------o------------o----------oB--Mo-------------?---?----B-MM?--------?--M-o-?-----B--M------B-o--------
M-------M----------M--o---oo-----oo----?-B-----B----?------B----------------o--M------o--M--------o---M---------oo-------------M-----------M-M--------------o-----------------B--------o-B------o------?
M-------o------B-o-------------------------------M---B-B----o---------------M-o---------M-o--------M-oo-------M----B?-------------------B-----?B-B-B---?ooo----ooo-----?---------?-------------o-----o-|
--------B----B---------M----B--------M---o??------------------M----------o-?-------?--------------?------------------------B-----B------o------------BM--o----o?-B-M---oo-?--?-------------------M-o---?
B----------o--?----oB----MT-------oX---?--T|----?--Bo------X----?|----B---M-|----T---M--T-?--o--B-----|-BB-M---------X-------T---|----------??|?-------oMB-B----T----o?-B--?----oT|--XX-?-----o--|?B---?
-------------T-------M-|-MX--o|--|-|---M---X---?---o-B---B---T----M---X-X-|--?M---?------X-o----|-----XT-------BB-X-----?X--X---o|----B--M-o|--|--M---|---|----M-?X----?----Xo---X-----M---M-M---|-----X
m----------?-|--BT-----T------o----X----o-M---oT-o-|--M----------X--|-M?-T-------B-?|-X----o-----X-o|--------Bo------M--?----B----|o-M-?----|-XX-|-XB-XToX--|-?-Mo--------?|---B--M------o-T---?-?BB-?--
XXXXXXXXXXXXXXXXXXXXXXXXXXXXXXXXXXXXXXXXXXXXXXXXXXXXXXXXXXXXXXXXXXXXXXXXXXXXXXXXXXXXXXXXXXXXXXXXXXXXXXXXXXXXXXXXXXXXXXXXXXXXXXXXXXXXXXXXXXXXXXXXXXXXXXXXXXXXXXXXXXXXXXXXXXXXXXXXXXXXXXXXXXXXXXXXXXXXXXXX
